111111111111111111111111111111
10P111111000000000000011111111
110111111111110111111111111111
110000000100000000010001010111
11C001111010000100100010000101
110011000011111111001111111101
1100000100000C0000000000000001
111111111110000000000100000111
110000000000000111111100000101
110E00000010100000100000010101
111111111111111111111111111111
110000010000000000000000000001
111111111110000000000100000111
110000000000000111111100000101
110000000010100000100000010101
111111111111111111111111111111
110000010000000000000000000001
111111111110000000000100000111
110000000000000111111100000101
110000000010100000100000010101
111111111111111111111111111111