1111111111111111111111111111111
1000000001000001000000001010E01
1000P0001000001C000000001000001
1000000001111000000111111111011
1000000000000000000000000000001
111111111100000000001000C000001
1000000C00000000000010000000001
1111111111111111111111111111111